1111111111111111
10P0000000000001
1000000000C001E1
1111111111111111
