11111111111111111111111111111111111111111111111111
1E000000000000000000000000000000000000000000000001
1C000111100010000010010000000100000010011111110001
10000100010010000010010000000100000010000010000001
10000100010010000010010000000100000010000010000001
10000100100010000010010000000100000010000010000001
10000100010010000010010000000100000010000010000001
10000100010010000010010000000100000010000010000001
10000111100011111110011111100111111110000010000001
1P000000000000000000000000000000000000000000000001
11111111111111111111111111111111111111111111111111
