111111111111111111111111111111111111111111111
1P0000000100000001000000001000001000000000E01
100000000010000010000000000100010000000000001
100000000001000100000000000010100000000000001
1000000C00001010000000C0000001000000000000001
10000001000001000000001000000C000000C00000001
10000010100001C000000101000000000000100000001
100001000100010000001000100000000001010000001
100010000010010000010000010000000010001000001
100100000001010000100000001000000100000100001
111111111111111111111111111111111111111111111