11111111111111111111
1E0000000000100C0001
10100101001010001011
10111100101000100011
1000P1000C0010000000
10000000000000000000
11111111111111111111
