11111111111111111111
1E0000000000100C0001
10100101001010001011
10111100101000100011
10000100000010000001
10000000000000000001
11111111111111111111
